##### ######
#        O #
#   P   ####
#          #
#          #
#######    
#  O ##    #
#    ##    #
           #
#       XX #
#       #  #
#### #######
